###### #################
#       # # # # # # ## #
# ## ####   # #   #  # #
#  ###  # #     #   ## #
##  ###   ## ## ###### #
###  #### #   #  ##    #
# ##  # # ## ## ##  ## #
#  ##   ###   #  # ##  #
##  # # #   #### ###  ##
### ### # #### #  #  ###
#    #    #  # ##   ## #
# ## ### ###    #####  #
# #    #   ####     ## #
###### ## ##    ###  # #
#  ##   #    #### ##   #
## #  # ###### #   ### #
##   ##     ##   ###   #
#  ########  ###   # ###
# ##  # # ##  #  #     #
#  # ##    ## # ##### ##
## #    ## #    #   ####
## ## #  ### # ## #### #
#     ##  #  #         #
################ #######
