###### #################
#       # # # # # #    #
#  K    #   # #   #    #
#       # #     #   ## #
##  ###   ## ## ###### #
###  #### #   #  ##    #
# ##  # # ## ## ##  ## #
#  ##   ###   #  # ##  #
##  # # #   #### ###  ##
### ### # #### #  #  ###
#    #    #  # ##   ## #
# ## ### ###    #####  #
# #    #   ####     ## #
###### ## ##    ###  # #
#  ##   #    #### ##   #
## #  # ###### #   ### #
##   ##     ##   ###   #
#  ########  ###   # ###
# ##  # # ##  #  #     #
#  # ##    ## # ##### ##
##### # ## #    #   ####
#     #  ### # ## #### #
# K   ##  #  #         #
################ #######
