# ##########################################
#   #     # #   # #             #     #
# ### # # # # # # # ####### # ### # # ######
#     # # #   # #   # #   # # #   # # #
# ####### ### # # ### # # # ### ##### # ####
# #   #   #   # #     # #   #   #   # #   #
# # # # ### ### ##### # ##### ### # # ### #
# # # #   #   # #   # # #     #   # #   # #
# # # ### ##### # ### # # # ### ### ### # #
#   # # #       #   # # # #   #   #   # #
##### # ########### # # ##### ### ### # ####
#   # #   # #     #   # #     #     # #
# # # ### # # # # ##### # ##### ### # # ####
# # #     # # # #     #   #   # #   # #   #
# # ### ### # # ##### ##### # # # ### ### #
# # # #     # #   #   #     # # #   #     #
# # # # ##### ### # ### ####### ############
# # # #     # # # # #   #       #   #
# # # ##### # # # # # # # ####### # # # ###
# # # #       #   #   # # #   #   #   # #
# # # # ########### ### # # # # ######### ##
# # #   #   #   #   #     # # # #   #   #
### ##### ### # # ### ##### # # # ### # ####
#       # #   # #   #   #   #   # #   # #
# ##### # # ### ### ##### ####### # ### # ##
# #   # #   #   # #     # #   #   #   #   #
# ### # # ### ### ##### # # # # ######### #
#   #   # #   #     #   # # #   #     #   #
# # ##### # ##### # ##### # ##### ### # ####
# #       #     # #   #   #     #   #   #
# ############# # # # ### ### # ### ##### ##
#   #           # # #   #   # #     #
# # ############# ##### ### ####### ########
# # #   #   #   #     #   #           #   #
# # # # # # # # ##### ### ########### # # ##
# #   #   # # #   #   #           # # # # #
# ######### # ### # ### ##### ### # # ### #
#     #     # #   #   #   #   #     #     #
##### # ##### # ####### ### ### ######### #
#     #     # #       # #     # #       # #
# ####### # # ####### ### ### # ####### # #
# #     # # #     #   #   #   #         # #
### # # ### ##### # ### ####### ######### ##
#   # #     #   # #   #     #   #   #   #
