############### ####
#   ## ##        #
## ##   ###### #   #
#   # #  #   ### ###
## #### ## #   # ##
#          ### # #
# # ### ####     # #
#####   # ### # ## #
##  ###   # ### #
#  ## ###     ### ##
##     #### ####  ##
### ## # #    #  ##
#    #   # ########
#### ### # # #    #
## #   ### # # ####
#  # ###   #     ##
